ABCDABCDABCDABCDABCDABCDABCDABCDABCDABCDABCDABCDABCDABCDABCD
EFGHEFGHEFGHEFGHEFGHEFGHEFGHEFGHEFGHEFGHEFGHEFGHEFGHEFGHEFGH
IJKLIJKLIJKLIJKLIJKLIJKLIJKLIJKLIJKLIJKLIJKLIJKLIJKLIJKLIJKL
MNOPMNOPMNOPMNOPMNOPMNOPMNOPMNOPMNOPMNOPMNOPMNOPMNOPMNOPMNOP
............ABCD............................................
............EFGH............................................
............IJKL............................................
............MNOP............................................
............ABCD............ABCD............................
............EFGH............EFGH............................
............IJKL............IJKL............................
............MNOP............MNOP............................
............ABCD........ABCD....ABCD....ABCD....ABCD....ABCD
............EFGH........EFGH....EFGH....EFGH....EFGH....EFGH
............IJKL........IJKL....IJKL....IJKL....IJKL....IJKL
............MNOP........MNOP....MNOP....MNOP....MNOP....MNOP
............ABCD....................ABCD....................
............EFGH....................EFGH....................
............IJKL....................IJKL....................
............MNOP....................MNOP....................
ABCDABCDABCDABCDABCDABCD....ABCDABCDABCDABCDABCD....ABCD....
EFGHEFGHEFGHEFGHEFGHEFGH....EFGHEFGHEFGHEFGHEFGH....EFGH....
IJKLIJKLIJKLIJKLIJKLIJKL....IJKLIJKLIJKLIJKLIJKL....IJKL....
MNOPMNOPMNOPMNOPMNOPMNOP....MNOPMNOPMNOPMNOPMNOP....MNOP....
!!!!!!!!...................ABCD.........................ABCD
,,,,,,,,...................EFGH.........................EFGH
,,,,,,,,...................IJKL.........................IJKL
########...................MNOP.........................MNOP
ABCDABCDABCDABCDABCDABCD....ABCDABCDABCDABCDABCD....ABCD....
EFGHEFGHEFGHEFGHEFGHEFGH....EFGHEFGHEFGHEFGHEFGH....EFGH....
IJKLIJKLIJKLIJKLIJKLIJKL....IJKLIJKLIJKLIJKLIJKL....IJKL....
MNOPMNOPMNOPMNOPMNOPMNOP....MNOPMNOPMNOPMNOPMNOP....MNOP....
............ABCD....................ABCD....................
............EFGH....................EFGH....................
............IJKL....................IJKL....................
............MNOP....................MNOP....................
............ABCD........ABCD....ABCD....ABCD....ABCD....ABCD
............EFGH........EFGH....EFGH....EFGH....EFGH....EFGH
............IJKL........IJKL....IJKL....IJKL....IJKL....IJKL
............MNOP........MNOP....MNOP....MNOP....MNOP....MNOP
............ABCD............ABCD............................
............EFGH............EFGH............................
............IJKL............IJKL............................
............MNOP............MNOP............................
............ABCD............................................
............EFGH............................................
............IJKL............................................
............MNOP............................................
ABCDABCDABCDABCDABCDABCDABCDABCDABCDABCDABCDABCDABCDABCDABCD
EFGHEFGHEFGHEFGHEFGHEFGHEFGHEFGHEFGHEFGHEFGHEFGHEFGHEFGHEFGH
IJKLIJKLIJKLIJKLIJKLIJKLIJKLIJKLIJKLIJKLIJKLIJKLIJKLIJKLIJKL
MNOPMNOPMNOPMNOPMNOPMNOPMNOPMNOPMNOPMNOPMNOPMNOPMNOPMNOPMNOP
